111111111111111111111
10000000000000C000001
1C1111111111111111001
100000000000000000001
111101111111111111101
100001000000000000001
101111111111111111101
100001000000000C00001
111101111111111111101
10000000000000000P001
101111111111111111101
100001000000000000001
1E1111111111111111001
111111111111111111111